#################################################################
#S#     #       #               #                       #   #   #
# ##### # ### # # ####### ##### ##################### ### # # # #
# #   #     # # #   #   #     #   #           #     #   # #   # #
# # # ##### # # ##### # ##### ### # ######### # ### ### # ##### #
#   #     # # #   #   #       # #   #       # # # #   #   #     #
######### ### ### # ########### ##### # ##### # # ### ##### #####
# #     # #   # # # #           #     #       # #     #   #     #
# # # ### # ### # # # ########### ############# # ##### # ##### #
#   #       #       #                           #       #      E#
#################################################################